The long walk (mirrored)
----------
-  -X    -
- ----- --
-        -
- --------
-        -
----- ----
-        -
-------- -
-G       -
----------