----------
-   G    -
-        -
-        -
-        -
- --------
-        -
-------- -
-   X    -
----------