The medium sized maze
------------------------------
-  -G+++  -             -    -
- -----+------- ----------- --
-+++++++ -      +++++++EHH   -
-+--------------+------+------
-++++++++++EHH- ++ -   ++++  -
----- -----+-----+--------+---
-         -+++++++ -   ++++  -
-------- ----- --------+------
-        -          -  +X    -
------------------------------
