The medium sized maze
------------------------------
-  -G+++  -             -    -
- -----+------- ----------- --
-+++++++ -      ++++++++     -
-+--------------+------+------
-+++++++++++  - ++ -   ++++  -
----- -----+-----+--------+---
-         -+++++++ -   ++++  -
-------- ----- --------+------
-        -          -  +X    -
------------------------------