----------
-  -G    -
- ----- --
-        -
- --------
-        -
----- ----
-        -
-------- -
-X       -
----------