------------------------------
-  -G     -             -    -
- ----- ------- ----------- --
-        -                   -
- -------------- ------ ------
-             -    -         -
----- ----- ----- -------- ---
-         -        -         -
-------- ----- -------- ------
-        -          -   X    -
------------------------------