-----------------
-  +++-     -   -
- -G-+--- ----- -
- - -+++++  - - -
--- -----+--- - -
-   -  +++-     -
- -----+----- - -
- - - -+-     - -
--- - -+- --- ---
- - - -+-+++- - -
- - - -+-+-+--- -
-      +++-++++X-
-----------------
