-------------------------
-     -           - -   -
----- --------- --- --- -
-           -   -       -
--- ----- ----- --- --- -
-   -   -     G+-   -   -
- --- - -------+--- - - -
-     -     -  +++- - - -
- ----- ---------+--- ---
- -         -    ++++++X-
-------------------------
