Test Maze 8
-----------------------
-                 -   -
- --- - ----- - - - ---
-   - -   -   - -     -
- --- - ----- --- - - -
- - - -   -   - - - - -
- - - --- --- - --- - -
-   -   -   -   - - - -
--- ----- --- --- -----
-   -   - - -   -   - -
- - --- - - - --- - - -
- - -   - -       - - -
----- - - ----- ----- -
-     -   - -   - - - -
- --- --- - - --- - - -
- -     - - -         -
----- - --- - ---------
- -   - - - - - -+++++-
- ----- - - --- -+---+-
-   -       -   -+- -+-
--- - ----- ---H-+- -+-
-         -  G+E+EH -X-
-----------------------
