Test Maze 9
-------------------------------
-         -     -     -       -
- --- ------- ----- --- --- ---
-   -   -   -         - - -   -
- ----- - --- --------- - -----
-     -   ++++-   -  HHE++++++-
----- - --G--+--- -----+--- -+-
- -   -   -  +    -   -+  - -+-
- ----- - ---+----- ---+- ---+-
-       - -HHE++++++++++-   -X-
-------------------------------
