nice maze
---------------------------------
- -+++++++++++++-+++- - -  +++- -
- -G--- - - ---+-+-+- - ---+-+- -
-     - - - - -+-+-++E++++-+-+++-
--- - - - --- -+-+- -H---+-+- -+-
-   - - -   -  +++- -H-  +++- -X-
---------------------------------