Test Maze 4
-----------------
-    +++++++-   -
-----+--- -+- ---
-+++++  - -+++  -
-+--- -------+- -
-+++-     -  +- -
---+--- -----+---
- HE  - - -++EHH-
---+--- - -+-----
-+++-   -  +++++-
-+--- ----- ---+-
-++ - -     - -+-
- G---- ----- -+-
-   -     - -  +-
--- --- - - ---+-
-     - - -  +++-
- - - - - - -+---
- - - - - - -++X-
-----------------
