Test Maze 10
-------------------------------
-           -   -     -       -
- - --- --- - - - --- - --- - -
- - - - - -   -     - - - - - -
----- - - ----------- --- --- -
- - -   -         -   - -     -
- - - - - --- --- --- - ----- -
-   - - - -   -     -     -   -
--- - - - ------- ------- --- -
-   - -   - - -   -   - -     -
- - --- - - - ----- - - ----- -
- - -   -   -   -   - -   -   -
--- - ----- - --- --- - --- - -
-   -     - HE++++++- -   - - -
--- ---------+- ---+----- --- -
- -   - -   ++- - HE++-   -   -
- - - - - - G--------+--- -----
- - - -   - - -   - -+++-+++++-
- - --------- - --- - -+-+---+-
-                     -+++  -X-
-------------------------------
