Test Maze 1
------------------------
-  +++++++G- - -+++-   -
- -+-------- - -+-+- - -
- -E++++-    -+++-+--- -
- -H---+  ----+---+++++-
---H- -+--+++-+- -----+-
-  H  -++++-++EHH-    X-
------------------------
