Test Maze 6
-----------------
- -       -     -
- - - --- --- ---
-   - -         -
- --- ------- ---
-   - -+++++-   -
-------+---+--- -
- - HE++-  +  - -
- - -G-----+--- -
-   -   - HE++- -
----- - - - -+- -
-     - - - -++X-
-----------------
