Test Maze 7
-----------------------
- -           -+++++++-
- - ------- ---+-----+-
-   G+-   -   -EHH  -+-
- ---+- -------+-----+-
-   -E++++++++++  -+++-
-----H----- - -----+---
- -  H-   - - - -  +++-
- - ----- - --- - - -+-
-         - -     - -X-
-----------------------
