Test Maze 5
---------------------------------
-   -   - - -+++++++++-     -   -
- ----- - - -+-------+--- ----- -
-+++-+++++++++  -+++++-   - - - -
-+-+-+--- --- ---+----- --- - - -
-+-+++-   -     -+++++++++  - - -
-+------- ---------------+- - - -
-+  -     - -   -   -    +-   - -
-+----- --- - - - - - ---+----- -
-+  -       - -   - -   -+++  - -
-+----------- -------------+--- -
-+++  - -  +++++- -   -+++++- - -
---+--- ---+---+-+G-- -+- - - - -
-+++-+++++++-HHE++-    +- -   - -
-+---+- - -------------+------- -
-+++-+- -   -   - - -+++- - -   -
- -+-+- ------- - - -+--- - --- -
- -+++- -   -        +++-       -
----- --- - ----- -----+------- -
-       - -   - - -  +++-       -
- --- --- ----- -----+--------- -
-   -     -   -      ++++++++++X-
---------------------------------
