Test Maze 2
------------------------
- --+G -++++++- -X---- -
- HHE---+----+- -+     -
- --+-+++--+++  -+--- --
- --+-+- -++-----+- - --
----+++- -+--++++E- -  -
-    -   -++++---H  -  -
------------------------
